00000000000000000000
00111101111111111100
00100101001000100100
00111111111111101110
00001010101000111010
00111010111100100010
00101110010001100011
00100100010011110010
00111101110110011010
00100101010010001010
11111111111110011110
01010000010010010010
01010000010011010010
01011000011001011110
01001111111001011010
01000000001111011010
01000000001001111010
01000000001001000010
01000000000000000010
01111111111111111110
