00000000000000000000
00000000000000000000
00000000000000000000
00000000000000000000
00000001111100111000
00000001000100101000
00111101000101111000
00100101000101000000
00100101000101000000
11100111111101001111
00000000000111001000
00000000000100001000
00000000000100001000
00000000000111111000
00000000000000000000
00000000000000000000
00000000000000000000
00000000000000000000
00000000000000000000
00000000000000000000
